0   0   0   0   0   0   0   0   0   0   5   0   0   0   0   0   0   0   0   0

0   4   3   4   3   3   4   3   4   0   5   0   0   0   0   0   0   0   0   0

0   2   0   0   0   0   0   0   2   0   5   0   0   0   0   0   0   0   0   0 

0   4   0   0   0   0   0   0   4   0   5   0   0   0   0   0   0   0   0   0 

0   2   0   0   7   0   0   0   2   0   5   0   0   0   0   0   0   0   0   0 

0   2   0   0   0   0   0   0   2   0   5   0   0   0   0   0   0   0   0   0

0   4   0   0   0   0   0   0   4   0   5   0   0   0   0   0   0   0   0   0

0   2   0   0   0   0   0   0   2   0   5   0   0   0   0   0   0   0   0   0

0   4   3   4   0   0   4   3   4   0   4   0   0   0   0   0   0   0   0   0

0   0   0   0   0   0   0   0   0   0   0   0   0   0   0   0   0   0   0   0

0   0   0   0   0   0   0   0   0   0   0   0   0   0   0   0   0   0   0   0

0   4   3   4   0   0   4   3   4   0   4   0   0   0   0   0   0   0   0   0

0   2   0   0   0   0   0   0   2   0   5   0   0   0   0   0   0   0   0   0 

0   4   0   0   0   0   0   0   4   0   5   0   0   0   0   0   0   0   0   0 

0   2   0   0   0   0   0   0   2   0   5   0   0   0   0   0   0   0   0   0 

0   2   0   0   0   0   0   0   2   0   5   0   0   0   0   0   0   0   0   0

0   4   0   0   0   0   0   0   4   0   5   0   0   0   0   0   0   0   0   0

0   2   0   0   0   0   0   0   2   0   5   0   0   0   0   0   0   0   0   0

0   4   3   4   3   3   4   3   4   0   5   0   0   0   0   0   0   0   0   0

0   0   0   0   0   0   0   0   0   0   5   0   0   0   0   0   0   0   0   0

